AHK	香港华民航空(Air Hong Kong)	AIR HONGKONG	CHINA
ALP	四川纵横航空	纵横/ALLPOINTS	CHINA
AMU	澳门航空(Air Macau)	AIR MACAU	CHINA
APA	安捷飞航训练中心(安捷航空)(APEX Flight Academy)	APEX	CHINA
AYE	云南英安航空	英安/AIR YING AN	CHINA
BDJ	北京金鹿公务	王冠/CROWN JET	CHINA
BFK	内蒙古北方快线通用航空	NORTHERN EXPRESS	CHINA
BFM	北京泛美国航空	泛美/FAN MAY	CHINA
BGC	北京国都公务航空	燕都/YANDU	CHINA
BJN	北京航空	京华/AIR JINGHUA	CHINA
BJN	北京航空	京华/AIR JINGHUA	CHINA
BJV	北京捷威航空	BEIJING VISTA	CHINA
BNB	博洋通用航空	钻石/DAZZLE	CHINA
BNH	广州宝能公务航空	雷霆/BAONENG JET	CHINA
BSH	北京首都航空直升机通用航空	首直/CAPITAL ROTOR	CHINA
BWJ	香港丽翔公务航空(Hk Bellawings Jet Limited)	BELLAWING	CHINA
CAF	中国人民解放军空军	军航/CHINA AIR FORCE	CHINA
CAL	中华航空(China Airlines)	华航/中华/DYNASTY	CHINA
CAO	中国国际货运航空	凤凰/AIR CHINA FREIGHT	CHINA
CBG	北部湾航空	浪花/GREEN CITY	CHINA
CBJ	首都航空	神鹿/CAPITAL JET	CHINA
CBW	丽翔公务(上海)	贝拉SUPERWINGS	CHINA
CCA	中国国际航空	国航/AIR CHINA	CHINA
CCD	大连航空	响箭/XIANGJIAN	CHINA
CCI	亚联航空(上海)	KUNGFU	CHINA
CCO	中航货运	远望/AVIC CARGO	CHINA
CCS	商飞快线	圆梦/COMAC EXPRESS	CHINA
CDC	浙江长龙航空	华龙/LOONG AIR	CHINA
CDG	山东航空	山东/SHANDONG	CHINA
CEC	中国东方航空公务	EASTERN JET	CHINA
CES	中国东方航空	东方/CHINA EASTERN	CHINA
CFA	中国飞龙通用航空	飞龙/FEILONG	CHINA
CFB	重庆申基通用航空	申基/FOREBASE	CHINA
CFI	中国民航飞行校验中心	校飞/CHINA JET	CHINA
CFJ	福建航空	福州/FUJIAN	CHINA
CFZ	中飞通用航空	中飞/ZHONGFEI	CHINA
CGH	桂林航空	超越/WELKIN	CHINA
CGN	长安航空	旭日/CHANG'AN	CHINA
CGZ	多彩贵州航空	黔兴/COLORFUL	CHINA
CHB	西部航空	西部/WEST CHINA	CHINA
CHC	中国海洋直升机	海直/CHINA HELICOPTER	CHINA
CHF	天津杰普逊国际飞行学院	朝飞/CHAO FEI	CHINA
CHH	海南航空	海南/HAINAN	CHINA
CHJ	星联商务航空	瑞能SHINING	CHINA
CJX	江西航空	仙鹤/AIR CRANE	CHINA
CKK	中国货运航空	货航/CARGO KING	CHINA
CNM	中国国际航空内蒙古公司	蒙元/MENGYUAN	CHINA
CNW	西北国际货运航空	隋唐/TANG	CHINA
CPA	国泰航空(Cathay Pacific)	CATHAY	CHINA
CQH	春秋航空	春秋/AIR SPRING	CHINA
CQN	重庆航空	重庆/CHONG QING	CHINA
CRK	香港航空(Hong Kong Airlines)	BAUHINIA	CHINA
CSC	四川航空	四川/SI CHUAN	CHINA
CSG	中国南方货运航空	开拓/SOUTHERN CARGO	CHINA
CSH	上海航空	上航/SHANGHAI AIR	CHINA
CSN	中国南方航空	南方/CHINA SOUTHERN	CHINA
CSS	顺丰航空	顺丰/SHUN FENG	CHINA
CSY	珠海中航通航	双阳/SHUANGYANG	CHINA
CSZ	深圳航空	深圳/SHENZHEN AIR	CHINA
CTH	上海东方通用航空	通航/TONGHANG	CHINA
CTJ	天津货运航空	劝业/TIANJIN CARGO	CHINA
CUA	中国联航	联航/CHINA UNITED	CHINA
CUH	乌鲁木齐航空	楼兰/LOULAN	CHINA
CWR	北京京城国际商务航空	环球/CITY WORLD	CHINA
CWU	武汉航空	武汉/WUHAN AIR	CHINA
CXA	厦门航空	白鹭/XIAMEN AIR	CHINA
CXI	山西航空	山西/SHANXI	CHINA
CXJ	新疆航空	新疆/XINJIANG	CHINA
CXN	雄安航空	自强/STRONG AIR	CHINA
CYE	鄂尔多斯通用航空	SAKIRA	CHINA
CYH	中国南方航空河南有限公司	豫昊/YUHAO	CHINA
CYN	七彩云南通用航空	缤纷/COLOR JET	CHINA
CYZ	邮政航空	邮政/CHINA POST	CHINA
DAC	德安航空(Daily Air)	德安DAILY	CHINA
DBH	东北航空	东北/DONGBEI AIR	CHINA
DBX	大白熊通用航空	WHITE BEAR	CHINA
DER	上海金鹿公务	金鹿/DEER JET	CHINA
DGA	黄河三角洲通用航空	黄河/YELLOW RIVER	CHINA
DJH	金鹿航空救援	JET FLAG	CHINA
DKH	吉祥航空	吉祥/AIR JUNEYAO	CHINA
DLC	德宏南亚通用航空	翱翔/SOAR COPTER	CHINA
DLJ	鼎龙商务航空	DING AIR	CHINA
DXH	东星航空	东星/EAST STAR	CHINA
EJE	河北通合通用航空	VOODOO	CHINA
EMU	空中快线直升机	EAST ASIA	CHINA
EPA	东海航空	东海/DONGHAI AIR	CHINA
EPB	东海航空（公务）	东捷/DONG JET	CHINA
EVA	长荣航空(EVA Air)	长荣/EVA	CHINA
FEA	远东航空（Far Eastern Air Transport）	远东/FAR EASTERN	CHINA
FJT	未来航空	远方/FUTURE AIR	CHINA
FSJ	环天通用航空	多维/FREE SKY	CHINA
FTJ	富泰公务航空	HU TAI	CHINA
FTU	中国民航飞行学院	飞院/FLIGHT UNIVERSITY	CHINA
FUH	吉林省福航航空学院	GALLANT	CHINA
FZA	福州航空	涌泉/STRAIT AIR	CHINA
GCR	天津航空	渤海/BO HAI	CHINA
GDC	大新华航空	大新华/GRAND CHINA	CHINA
GHL	桂林通航	GUILIN ROTOR	CHINA
GSC	银河货运航空	银河/GRANDSTAR CARGO	CHINA
GUC	普洱通用航空	LEAF AIR	CHINA
GWL	长城航空	长城/GREAT WALL	CHINA
HAH	汉华公务	汉马/HANMA	CHINA
HAJ	幸福通用航空	DINGCHANG	CHINA
HBH	河北航空	河北/HEBEI AIR	CHINA
HDA	香港港龙航空(Hong Kong Dragon Airlines)	DRAGON	CHINA
HFJ	懿丰公务航空	盘古/PANGU	CHINA
HGB	大湾区航空(Greater Bay Airlines)	GREATER BAY	CHINA
HHG	汉能公务航空	瑞能/HANERGY JET	CHINA
HKC	香港货运航空(Hong Kong Air Cargo)	MASCOT	CHINA
HKE	香港快运(HK Express)	HONGKONG SHUTTLE	CHINA
HKG	香港政府飞行服务队(Government Flying Service Of The Hong Kong Special  Administrative Region)	HONGKONG GOVERNMENT	CHINA
HKJ	香港商务航空(Hongkong Jet)	HONGKONG JET	CHINA
HLF	中州航空	牡丹/HOMELAND	CHINA
HNJ	华南国际商务航空	华南/SOUTHERN JET	CHINA
HNX	海南航空学校	卓越SUPERB	CHINA
HSJ	北京弘盛航空	宝升/BAOSHENG	CHINA
HSV	香港直升机服务有限公司(Heliservices (Hk) Ltd)	VERTIFLIGHT	CHINA
HTK	宁夏货运航空	灵雀/LINGBIRD	CHINA
HTU	红土航空	乐途/HONG LAND	CHINA
HXA	华夏航空	华夏/CHINA EXPRESS	CHINA
HYJ	快乐公务航空	HAPPY JET	CHINA
HYN	深圳福年商务航空	福年/FANTASIA	CHINA
HYT	圆通航空	速派/QUICK AIR	CHINA
ICU	华彬亚盛通用航空	亚盛/ASIA MEDICAL	CHINA
IDO	越南中南航空	INDOKHMER	CHINA
JAE	翡翠航空	翡翠/JADE CARGO	CHINA
JBE	北京华龙商务航空	北极熊/SINO JET	CHINA
JDL	江苏京东货运航空	展翅/JINGDONG	CHINA
JGJ	陕西精功通用航空	精功/GLOBAL JINGGONG	CHINA
JHK	西安航空基地金胜通用航空	胜利/SHENGLI	CHINA
JKT	捷星香港航空(Jetstar Hong Kong Airways Limited)	KAITAK	CHINA
JOY	幸福航空	幸福/JOY AIR	CHINA
JSU	江苏公务航空	苏润/SU JET	CHINA
JXX	海南晋祥航空	晋祥COCONUT	CHINA
JYH	九元航空	如意/TRANS JADE	CHINA
JYH	九元航空	如意/TRANS JADE	CHINA
KJT	上海金汇通用航空	金汇/SHANGHAI KINGJET	CHINA
KNA	昆明航空	昆航/KUNMING AIR	CHINA
KPA	鲲鹏航空	鲲鹏/KUNPENG	CHINA
KXA	江西快线通用航空	快线/FINDER AIR	CHINA
LHA	中原龙浩航空	木棉/AIR CANTON	CHINA
LHG	深圳首领航空	AIR LEADER	CHINA
LKE	祥鹏航空	祥鹏/LUCKY AIR	CHINA
LLJ	北京美邦通用航空	美邦/MAYBOUNE JET	CHINA
LNM	辽宁子午线航空	子午线/AIR RING	CHINA
MDA	台湾华信航空(Mandarin Airlines)	华信/MANDARIN	CHINA
MJC	北京汉宇航空	汉宇AIR MANDA	CHINA
MMJ	澳门国际商务航空(Macau Jet International)	MACAUJET	CHINA
MSF	民生国际通用航空	民生/MINSHENG	CHINA
MTJ	美捷航空	METROJET	CHINA
MYK	北京美麟通用航空有限公司	帝麒麟MYLIN	CHINA
MZT	中一太客商务航空	中太/ZHONG TAI	CHINA
NEJ	利捷公务航空	利捷/NET BUSINESS	CHINA
NMG	天骄航空	牧歌/TIANJIAO AIR	CHINA
NSJ	南山公务	南山/NANSHAN	CHINA
NSY	山东南山国际飞行有限公司	群英/QUNYING	CHINA
OHK	香港甘泉航空(Oasis Hong Kong Virtual)	OASIS	CHINA
OKA	奥凯航空	奥凯/OKAY JET	CHINA
OLD	北京奥伦达部落通航	奥伦达/AIR ORENDA	CHINA
OMA	中国人民解放军空军/OMAN AIR	军航/AIR FORCE/OMAN AIR	CHINA
OTC	湖南航空	乐程/AIR TRAVEL	CHINA
OTT	一二三航空	齐嘉/OTT AIRLINES	CHINA
OUF	北京欧法国际商务航空	ELEMENT	CHINA
PHF	陕西凤凰国际飞行学院	陕凰/SHAN FENG	CHINA
QBD	青岛空中快线通用航空	SEAGULL AIR	CHINA
QDA	青岛航空	胶澳/SKY LEGEND	CHINA
QJT	青岛九天国际飞行学院	九天/JIU TIAN	CHINA
QSR	耀莱通用航空	耀莱/SPARKLE ROLL	CHINA
RBW	山东航空彩虹公务机有限公司	彩虹/CAI HONG	CHINA
RFH	云南瑞锋通用航空	瑞峰/NUT	CHINA
RLH	瑞丽航空	森地/SENDI	CHINA
RXF	日照锐翔通用航空	AIDEN	CHINA
RZT	河南新通商公务航空	RITZ JET	CHINA
SAG	南航通用航空	四季AERO EAGLE	CHINA
SAJ	SAINT JET CO.	LTD.	SAINT JET
SHQ	上海国际货运航空	上货航/SHANGHAI CARGO	CHINA
SJM	北京华龙商务航空	SINO SKY	CHINA
SJX	星宇航空(STARLUX Airlines)	STARWALKER	CHINA
SNG	龙江航空	雪雕/SNOW EAGLE	CHINA
SOU	南太平洋航空	PARADISE	CHINA
STJ	天骄通用航空(苏州)	KINGSMAN	CHINA
SXJ	山西神飞通用航空	晋翼BIG WING	CHINA
SZA	星雅通用航空	星雅/AIR ASTRO	CHINA
TBA	西藏航空	西藏/TIBET	CHINA
TBJ	TAG航空亚洲	TAG JET	CHINA
TCI	天成商务航空	AMBER	CHINA
TNA	复兴航空（TransAsia Airways）	复兴/TRANSASIA	CHINA
TTW	台湾虎航(TigerAir Taiwan)	SMART CAT	CHINA
TXJ	亚洲商务航空	梧桐/TAIXIANG	CHINA
UEA	成都航空	锦绣/UNITED EAGLE	CHINA
UNA	亚联公务	亚联/UNITED ASIA	CHINA
UNI	立荣航空(UNI Air)	立荣/GLORY	CHINA
UTP	友和道通航空	友和/UNITOP	CHINA
VGA	山西成功通用航空	成功/AIR VICTORY	CHINA
VGB	北京天鑫爱通用航空	HONG XIANG	CHINA
VVM	澳门非凡航空(Viva Macau Limited)	JACKPOT	CHINA
WED	安徽蓝天国际飞行学院	WENDA	CHINA
WFH	万丰通用航空	万威/WANFENG	CHINA
WHG	浙江万丰通用航空	CHEER	CHINA
WLF	湖北蔚蓝国际航空学校	蔚蓝/SKY BLUE	CHINA
WUA	亚捷通用航空无锡	候鸟/YAJIE AIR	CHINA
XAI	尊翔公务航空	爱客/PEX AIR	CHINA
XTH	新疆通用航空	明珠/BRIGHT PEARL	CHINA
YZR	金鹏航空	扬子江/YANGTZE RIVER	CHINA
ZFP	中国民航ATMB飞行计划管理中心		CHINA
HAZ	杭州航空（VATSIM虚航）	钱塘/HANGZHOU	CHINA
CJH	菊花航空（VATSIM虚航）	菊花/CHRYSANT	CHINA
OVO	海岸航空（VATSIM虚航）	五维/JELLYFISH	CHINA